A #######
#       #
### ### #
#       #
# ##### #
#       B
#########
