#################################
#                           ##  #
# ####### # ##### # #######   # #
# #     # # #   # #     # # #   #
# # ### # # # # # ####### # # # #
# # #   # # # # # #     # # # # #
# # # ### # ### # # ##### # # # #
# # #     #   # # #     # # # # #
# ### ####### # # ####### # # # #
#   #        #   #       #  #   #
##### ####### # ##### ####### # #
#     #     # #     #       #   #
##### # ##### # # ##### ####### #
#     #       #     #   #   # # #
# ####### ##### ##### # ### # # #
# #     #     #       # # # # # #
# # ##### ##### ####### # # # # #
# #     #   #         # # #   # #
# ##### # # ####### # # ### ### #
#         #         #         # #
############################# # #
#A                            #B#
#################################
