##########################################
A                                        
# ########### ####### ########### #######
# #         #       #         #         #
# # ####### # ####### # ####### # #######
# # #     # #       # #     # # #     # #
# # # ### # ######### # ### # # # ### # #
# # # # # #         # # # # # # # # # # #
# # # # # ########### # # # # # # # # # #
# # # # #           # # # # # # # # # # #
# # # ########### # # # # ### # # # ### #
# # #           # # # #       # #       ##
# ####### ####### # # ########### ########
#               # #               ##B    #
########### ##### # ################## ###
#               # #                  #   #
# ############# # ################## ### #
#               #                    #   #
############### #################### ### #
#                                        #
##########################################
