A #######
#       #
# ##### #
#       #
##### # #
# B     #
#########
